* * * * * * * * * * * * * * * * * * * * * 
* 1 * . . . . . . . . . . . . . . . . 2 * 
* . * . * . * * * * . . * * * * * * * . * 
* . . . * . . . . . * . * . . . * . . . * 
* * * . * * * * * . * . . . * . * . * . * 
* . . . * . . . * . . . * . * . . . * . * 
* . . * * . * . * . . * * . * * * . . . * 
* . . . . @ * . * . . . * . . @ * . * . * 
* . * * * * . . . . * . . . * . * * * . * 
* . . . . . * . . . . P . . * . . . . . * 
* * * * * . * * * . * * . * * * . * * . * 
* . . . * . . . . . . . * . . . . . . . * 
* . * . * . * . . * * . * . * . . . * . * 
* . * . . @ . . * . . . * . . @ * . * . * 
* * . . * * * * . . * . * * . . * . * . * 
* . . . . . . . . . * . . . . . * . . . * 
* . . * * . . . * . * * * . * * * * . . * 
* 3 . . . . . . . . . . . . * . . . . 4 * 
* * * * * * * * * * * * * * * * * * * * * 
